WWWWWWWWWWWWWWWWWWWWWWWWWWWWWWW
WHTGGGGGGGGGGTTCTTGGGGGGGGGGTHW
WHTTGGGGGGGGGGGGGGGGGGGGGGGTTHW
WHHTTGGGGGGGGGGGGGGGGGGGGGTTHHW
WHHHTTGGGGGGGGGGGGGGGGGGGTTHHHW
WHHHHTTGGGGGGGGGGGGGGGGGTTHHHHW
WHHHHHTTGGGGGGGGGGGGGGGTTHHHHHW
WHHHHHHTTGGGGGGGGGGGGGTTHHHHHHW
WHHHHHHHTTGGGGGGGGGGGTTHHHHHHHW
WHHHHHHHHTTGGGGGGGGGTTHHHHHHHHW
WHHHHHHHHHTTGGGGGGGTTHHHHHHHHGW
WHHHHHHHHHHTTTPPPTTTHHHHHHHHHGW
WHHHHHHHHHHHHTPPPTHHHHHHHHHHHGW
WHHHHHHHHHHHHHPPHHHHHHHHHHHHHGW
WHHHHHHHHHHHHHHHHHHHHHHHHHHHHGW
WHHHHHHHHHHHHHHPPHHHHHHHHHHHHGW
WHHHHHHHHHHHHHPPPPHPPPPPHHPPPGW
WHHHHHHHHHHHHHPPPPHPPPPPHPPPPGG
WHHHHHHHHHHHHHHPPPHHHPPPHHHPPGW
WHHHHHHHHHHHHHHHHHHHHHHHHHHHHGW
WHHHHHHHHHHHHHHHHHHHHHHHHHHHHGW
WHHHHHHHHHHHHHHHHHHHHHHHHHHHHGW
WHHHHHHHHHHHHHHHHHHHHHHHHHHHHGW
WHHHHHHHHHHHHHHHHHHHHHHHHHHHHGW
WHHHHHHHHHHHHHHHHHHHHHHHHHHHHGW
WWWWWWWWWWWWWWWWWWWWWWWWWWWWWWW
