WWWWWWWWWWWWWWWWWWWWWWWWWWWWWWW
WGGGGGGGTWWPPPWZWPPPWWTGGGGGGGW
WGTGGGGGTWWPPPPPPPPPWWTGGGGGTGW
WGTGGGGGTWWPPPPPPPPPWWTGGGGGTGW
WGTGGGGGTWWPPPPPPPPPWWTGGGGGTGW
WGTGGGGGTWWPPPPPPPPPWWTGGGGGTGW
WGTGGGGGTWWPPPPPPPPPWWTGGGGGTGW
WGTGGGGGGTWPPPPPPPPPWTGGGGGGTGW
WGTGGGGGGTWPPPPPPPPPWTGGGGGGTGW
WGTGGGGGGTWPPPPPPPPPWTGGGGGGTGW
WGTGGGGGGTWWWWWPWWWWWTGGGGGGTGW
WGTGGGGGGGTTTWWPWWTTTGGGGGGGTGW
WGTGGGGGGGGGGTWPWTGGGGGGGGGGTGW
WGTGGGGGGGGGGTPPPTGGGGGGGGGGTGW
WGTGGGGGGGGGGTPPPTGGGGGGGGGGTGW
WGTGGGGGGGGGGGPPPGGGGGGGGGGGTGW
WGTGGGGGGGGGGGPPPGGGGGGGGGGGTGW
WGTGGGGGGGGGGGPPPGGGGGGGGGGGTGW
WGTGGGGGGGGGGGPPPGGGGGGGGGGGTGW
WGTGGGGGGGGGGGPPPGGGGGGGGGGGTGW
WGTGGGGGGGGGGGPPPGGGGGGGGGGGTGW
WGTGGGGGGGGGGGPPPGGGGGGGGGGGTGW
WGTGGGGGGGGGGGPPPGGGGGGGGGGGTGW
WGTGGGGGGGGGGGPPPGGGGGGGGGGGTGW
WGGGGGGGGGGGGGPPPGGGGGGGGGGGGGW
WWWWWWWWWWWWWWWPWWWWWWWWWWWWWWW
