WWWWWWWWWWWWWWWWWWWWWWWWWWWWGGW
WGGGGGHHHHHHHHHHHHHHHHHHHHHWTTW
WGTTTGHHHHHHHHHHHHHHHHHHHHHWTTW
WGTTTGHHHHHHHHHHHHHHHHHHHHHWTTW
WGGGGGHHHHHHHHHHHHHHHHHHHHHWGGG
WGGGGGHHHHHHHHHHHHHHHHHHHHHWGGG
WGGGGGHHHHHHHHHHHHHHHHHHHHHWWWW
WGGGGGHHHHHHHHHHHHHHHHHHHHHHGGW
WGGGGGHHHHHHHHHHHHHHHHHHHHHHGGW
WGGGGGHHHHHHHHHHHHHHHHHHHHHHGGW
WPPPPPPPPPPPPPPPPPPPPPPPPPPPPPW
PPPPPPPPPPPPPPPPPPPPPPPPPPPPPPP
PPPPPPPPPPPPPPPPPPPPPPPPPPPPPPP
WPPPPPPPPPPPPPPPPPPPPPPPPPPPPPW
WGGGGGHHHHHHHHHHHHHHHHHHHHHHGGW
WGGGGGHHHHHHHHHHHHHHHHHHHHHHGGW
WGGGGGHHHHHHHHHHHHHHHHHHHHHHGGW
WGGGGGHHHHHHHHHHHHHHHHHHHHHHGGW
WGGGGGHHHHHHHHHHHHHHHHHHHHHHGGW
WGGGGGHHHHHHHHHHHHHHHHHHHHHHGGW
WGGGGGHHHHHHHHHHHHHHHHHHHHHHGGW
WGGGGGHHHHHHHHHHHHHHHHHHHHHHGGW
WGTTTGHHHHHHHHHHHHHHHHHHHHHHTTW
WGTTTGHHHHHHHHHHHHHHHHHHHHHHTTW
WGGGGGHHHHHHHHHHHHHHHHHHHHHHTTW
WWWWWWWWWWWWWWWWWWWWWWWWWWWWWWW
