WWWWWWWWWWWWWWWWWWWWWWWWWWWWWWW
WNNNNNNNNNN          HHHHHHHHHW
WNNNNN               EHHHHHHHHW
W        E      E      HHHHHH W
G                       HHHHH  
G                        HHHH W
W             E           HHHHW
W      E                   HHHW
WNNNNN                      HHW
WNNNNNNNNNNN                HHW
WWWWWWWWWWWWWWWWWWHHHHHHH   HHW
  N     N     N  WHHHHHHH   HHW
     N     N     WHHHHHHH   HHW
WWWWWWWWWWWWWWW  WHHHHHHH   HHW
W   E  NNNNNNNW  WHHHHHHH   HHW
W     NNNNNNNNW  WHHHHHHH   HHW
W  W   WNNNNNNW  WHHHHHHH   HHW
W NW   WWNNNNNW NWHHHHHHH   HHW
W  WN  NWWWNNNW  WHHHHHHH   HHW
W  W      WWWWW  WHHHHHHH   HHW
W  WN EN N N   N WWWWWWWWW WWWW
WN W             W   N   N WWWW
W  WWWWWWWWW E WWW N N N N WWWW
W NE    NNNWWWWW   N N N N WWWW
W   N            W N   N   WWWW
WWWWWWWWWWWWWWWWWWWWWWWWWWWWWWW
