WWWWWWWWWWWWWWWWWWWWWWWWWWWWWWW
WTGGGTHHHHHHHSSSSSHHHHHHHTGGGTW
WTGGGTHHHHHHHSSXSSHHHHHHHTGGGTW
WTGGGTHHHHHHHSPPPSHHHHHHHTGGGTW
WTGGGTHHHHHHHSPPPSHHHHHHHTGGGTW
WTGGGTHHHHHHHHPPPHHHHHHHHTGGGTW
WTGGGTHHHHHHHHPPPHHHHHHHHTGGGTW
WTGGGTHHHHHHHHPPPHHHHHHHHTGGGTW
WTGGGTHHHHHHHHPPPHHHHHHHHTGGGTW
WTGGGTHHHHHHHHPPPHHHHHHHHTGGGTW
WTGGGTHHHHHHHHPPPHHHHHHHHTGGGTW
WTGGGTHHHHHHHHPPPHHHHHHHHTGGGTW
WTGGGTHHHHHHHHPPPHHHHHHHHTGGGTW
WTGGGTTTTTTTTTPPPTTTTTTTTTGGGTW
WTGGGGGGGGGGGGPPPGGGGGGGGGGGGTW
WTGGGGGGGGGGGGPPPGGGGGGGGGGGGTW
WTGGGGGGGGGGGGPPPGGGGGGGGGGGGTW
WTGGGGGGGGGGGGPPPGGGGGGGGGGGGTW
WTGGGGGGGGGGGGPPPGGGGGGGGGGGGTW
WTGGGGGGGGGGGGPPPGGGGGGGGGGGGTW
WTTTTTTTTTTTTTPPPTTTTTTTTTTTTTW
WWWWWWWWWWWWWWPPPWWWWWWWWWWWWWW
WTTTTTTTTTTTTTPPPTTTTTTTTTTTTTW
WGGGGGGGGGGGGGPPPPPPPPPPPPPPPPW
WGGGGGGGGGGGGGPPPPPPPPPPPPPPPPW
WWWWWWWWWWWWWWWWWWWWWWWWWWWWPPW
