WWWWWWWWWWWWWWWWWWWWWWWWWWWWWWW
WL NNNNNNNNNNNNNNNNNNNNNNN    W
W  NNNNNNNNNNNNNNNNNNNNNNNN   W
WNNNNNNN  NNNNNN NNNNNNNNNN L W
WNNNN     NNNNN      NNNNNN   W
WNNN  L   NNNNN       NNNNN   W
WNNN     NNNNNN   L  NNNNNNN  W
WNNNN   NNNNNNN       NNNNNNNNW
WNNNNNNNNNNNNNNNN     NNNNNNNNW
WNNNNNNNNNNNNNNNNN  NNNNNNNNNNW
WNNNNNNNNNNNNNNNNNNNNNNNNNNNNNW
WPPPPPPPPPPPPPPPPPPPPPPPPPPPPPW
PPPPPPPPPPPPPPPPPPPPPPPPPPPPPPJ
WPPPPPPPPPPPPPPPPPPPPPPPPPPPPPW
WNNNNNNNNNNNNNNNNNNNNNNNNNNNNNW
WNNNNNNNNNNNNNNNNNNNN     NNNNW
WNNNNNNNNNNNN  NNNNNN     NNNNW
WNNNNNNNNN     NNNNNN      NNNW
WNNNNNNNN      NNNNNNN  L  NNNW
WNNNNNNNN  L   NNNNNN      NNNW
W NNNNNNNN     NNNNN      NNN W
W    NNNNN    NNNNNNN    NNN  W
W     NNNNNNNNNNNNNNNNNNNNN   W
W L   NNNNNNNNNNNNNNNNNNNNN  LW
W     NNNNNNNNNNNNNNNNNNNNN   W
WWWWWWWWWWWWWWWWWWWWWWWWWWWWWWW
