WWWWWWWWWWWWWWWWWWWWWWWWWWWWWWW
WNNNNNNNNNN  V  NNNNNNNN   N  W
WNNNNNNNNNN L L NNNNNNNN  NN  W
WNNNNNNNNN       NNNNNNN  N   W
WNNNNNNNNN        NNNNN   N   W
WNNNNNNNNN        NNNNN   NN  W
WNNNNNNNNN        NNNN     N  W
WNNNNNNNNN       NNNNN     NN W
WNNNNNNNNNN      NNNNN  N  N  W
W  NNNNNNNNN     NNNNNN NN NN W
WRR NNNNNNNN     NNNNNN  N  N W
WLR  NNNNNN     NNNNNNN  N  N W
WLR  NNNNNN     NNNNNNN  N  N R
WLR  NNNNNN     NNNNNN      N R
WRR NNNNNNN     NNNNNN      N W
W  NNNNNNNN     NNNNNN    N N W
WNNNNNNNNNNN    NNNNN    NN N W
WNNNNNNNNNNN    NNNN     N  N W
WNNNNNNNNNNN    NNNN     N  N W
WNNNNNNNNNNN   NNNNN     N NN W
WNNNNNNNNNNN   NNNNN     N N  W
WNNNNNNNNNNNN  NNNNNN   NN NN W
WNNNNNNNNNNNN  NNNNNN       N W
WNNNNNNNNNNNN  NNNNNN      NN W
WNNNNNNNNNNNN  NNNNNN      N  W
WWWWWWWWWWWWW  WWWWWWWWWWWWWWWW
