WWWWWWWWWWWWWWWPWWWWWWWWWWWWWWW
WGGGGGGGGGGGGGPPPGGGGGGGGGGGGGW
WGTTTGGGGGGGGGPPPGGGGGGGGGTTTGW
WGTHTGGGGGGGGGPPPGGGGGGGGGTHTGW
WGTTTGGGGGGGGGPPPGGGGGGGGGTTTGW
WGGGGGGGGGGGGGPPPGGGGGGGGGGGGGW
WGGGGGGGGGGGGGPPPGGGGGGGGGGGGGW
WGGGGGGGGGGGGGPPPGGGGGGGGGGGGGW
WGGGGGGGGGGGGGPPPGGGGGGGGGGGGGW
WGGGGGGGGGGGGGPPPGGGGGGGGGGGGGW
WGGGGGGGGGGGGGPPPGGGGGGGGGGGGTW
WGGGGGGGGGGGGGPPPPPPPPPPPPPPPTT
WGGGGGGGGGGGGGPPPPPPPPPPPPPPPTT
WGGGGGGGGGGGGGPPPGGGGGGGGGGGGTW
WGGGGGGGGGGGGGPPPGGGGGGGGGGGGGW
WGGGGGGGGGGGGGPPPGGGGGGGGGGGGGW
WGGGGGGGGGGGGGPPPGGGGGGGGGGGGGW
WGGGGGGGGGGGGGPPPGGGGGGGGGGGGGW
WGGGGGGGGGGGGGPPPGGGGGGGGGGGGGW
WGGGGGGGGGGGGGPPPGGGGGGGGGGGGGW
WGGGGGGGGGGGGGPPPGGGGGGGGGGGGGW
WGTTTGGGGGGGGGPPPGGGGGGGGGTTTGW
WGTHTGGGGGGGGGPPPGGGGGGGGGTHTGW
WGTTTGGGGGGGGGPPPGGGGGGGGGTTTGW
WGGGGGGGGGGGGGPPPGGGGGGGGGGGGGW
WWWWWWWWWWWWWWWWWWWWWWWWWWWWWWW
