WWWWWWWWWWWWW  WWWWWWWWWWWWWWWW
WNNNNNNNNNNNN  NNNNNNNNNNNNNNNW
WNNNNNNNNNNNN   NNNNNNNNNNNNNNW
WNNNNNNNNNNNNN  NNNNNNNNNNNNNNW
WNNNNNNNNNNNNN  NNNNNNNNNNNNNNW
WNNNNNNNNNNNNN   NNNNNNNNNNNNNW
WNNNNNNNNNNNNN E  NNNNNNNNNNNNW
WNNNNN       N     NNNNNNNNNNNW
WNNNN        NN     NNNNNNNNNNW
WNNNN    E   SNNN       S  NNNW
WNNNN       S    NNN    S   NNW
WNNNWSWNNNN S      NNNNS    NNW
WNNNW WNNNNNN       SSNNN    NW
WWWNW WNNNSSNNN    E    NN   NW
W WWW WNNNS   NNN     S  N    W
W     WNN       NNN      N    W
W WWW WNN     E    NS    N    W
W WNWWWN           S     N  E W
WSWNNNNN    E      S     N    W
  WNNNN             S    N    W
W WNN               S  NNN    W
WWWNN       NNNNNNNNNNNN      W
WNNNN  SSNNNN   NN     S    NNW
WNNNNNS       E         S  NNNW
WNNNNNNN                S NNNNW
WWWWWWWWWWWWWWWWWWWWWWWWWWWWWWW
