WWWWWWWWWWWWWWWWWWWWWWWWWWWWWWW
WH   WNNNNNNNNNNNNNN      NNNNW
WH   WNNNNNNNNNNNNNN       NNNW
WH   WWNNNNNNNNNNNNN     E  NNW
WHH   WNNNNNNNNNNNN          NW
WHH   WNNNNNNNNNNNN           W
WHH   WWNNNNNNNNNNN           W
WHH    WNNNNNNNNNN   E    RRRRW
WHH    WNNNNNNNNN         RRRRW
WHHH   WWNWWWWWNW        RRRRRW
WHHHH   WWWSSSSRW       RRRRRRW
WRHHH E W  S    W  E   RRRRRRRW
 RHHH   R  S    W      RRRRRR  
 RHHH   R  S    W      RRRRRRRW
WRHHH E W  S    W  E   RRRRRRRW
WHHHH   WWWSSSSRW       RRRRRRW
WHHH   WWNWWWWWNW        RRRRRW
WHH    WNNNNNNNNN         RRRRW
WHH    WNNNNNNNNNN   E    RRRRW
WHH   WWNNNNNNNNNNN           W
WHH   WNNNNNNNNNNNN           W
WHH   WNNNNNNNNNNNN          NW
WH   WWNNNNNNNNNNNNN     E  NNW
WH   WNNNNNNNNNNNNNN       NNNW
WH   WNNNNNNNNNNNNNN      NNNNW
WWWWWWWWWWWWWWWWWWWWWWWWWWWWWWW
